id				(string)	id объявления (MD5-хэш от URL)
forumId			(integer)	id источника (например, ЮЛА - 284)
name			(string)	Имя объявления
text			(string)	Текст объявления
cost			(integer)	Цена в рублях
url				(string)	URL-адрес объявления
fullAddress		(string)	Полный адресс объекта
latitude		(number)	Широта
longitude		(number)	Долгота
images			(string)	Ссылки на изображения (URL через ';')

typeCode		(integer)	Тип недвижимости (1 - квартира, 2 - комната, 3 - загородная, 4 - коммерческая, 5 - гараж или машиноместо)
taskCode		(integer)	Тип сделки (1 - продажа, 2 - аренда, 3 - в резерве)
balcony			(boolean)	Наличие балкона
loggia			(boolean)	Наличие лоджии
roomQuantity	(integer)	Количество комнат
passLift		(boolean)	Наличие пассажирского лифта
cargoLift		(boolean)	Наличие грузового лифта
floor			(integer)	Этаж объекта
floors			(integer)	Количество этажей
buildYear		(integer)	Год постройки
totalArea		(number)	Общая площадь (в кв.м.)
kitchenArea		(number)	Площадь кухни (в кв.м.)
livingarea		(number)	Жилая площадь (в кв.м.)
landArea		(number)	Площадь участка (в сотках)
repair			(integer)	Ремонт (1 - не требуется, 2 - требуется ремонт, 3 - косметический, 4 - евроремонт, 5 - дизайнерский, 6 - капитальный ремонт)
bathroomType	(integer)	Тип санузла (1 - совмещенный, 2 - раздельный, 3 - 2 и более, 4 - на улице, 5 - в доме)
isOwner			(boolean)	Является ли собственником
wallMaterial	(integer)	Материал стен дома (1 - панельный, 2 - кирпичный, 3 - монолитный, 4 - кирпично-монолитный, 5 - блочный, 6 - деревянный, 7 - щитовой)
tenure			(integer)	Срок владения (1 - до 3-х лет, 2 - от 3 до 5 лет, 3 - более 5 лет)
housing			(integer)	Тип квартиры (1 - вторичка, 2 - Новостройка)

fridge			(boolean)	Наличие холодильника
dishWasher		(boolean)	Наличие посудомоечной машины
washer			(boolean)	Наличие стиральной машины

commissionType	(integer)	Тип комиссии (1 - нет, 2 - 30%, 3 - 50%, 4 - 100%, 5 - другая)
utilitiesInclude(boolean)	Включены ли коммунальные услуги
prepayType		(integer)	Тип предоплаты (1 - без предоплаты, 2 - 1 месяц, 3 - 2 месяца, 4 - 3 месяца, 5 - 4 и более месяцев)

electricity		(boolean)	Наличие электричества
gas				(boolean)	Наличие газа
heating			(boolean)	Наличие отопления
waterSupply		(boolean)	Наличие водоснабжения
garage			(boolean)	Наличие гаража

bedrooms		(integer)	Количество спален

buildingType	(integer)	Тип строения (1 - дом, 2 - таунхаус, 3 - коттедж, 4 - дача, 5 - Помещение свободного назначения, 6 - торговое помещение, 7 - офисное помещение, 8 - производство, 9 - склад, 10 - другая коммерческая недвижимость)
plotType		(integer)	Тип участка (1 - cельхоз (СНТ или ДНП), 2 - фермерское хоз-во, 3 - поселения (ИЖС), 4 - земля промназначения, 5 - инвестпроект)
